############
#  O      #
#  P  ####
#        #
#######  #
#  O  ## #
#     ## #
#        #
#   XX   #
#   #    #
############